WsLargeDataIO	github.com/kbaseapps/WsLargeDataIO
HTMLFileSetServ	github.com/kbaseapps/HTMLFileSetServ
DataFileUtil	github.com/kbaseapps/DataFileUtil
GenomeFileUtil	github.com/kbaseapps/GenomeFileUtil
KBaseDataObjectToFileUtils	github.com/kbaseapps/KBaseDataObjectToFileUtils
GenomeAnnotationAPI	github.com/kbase/genome_annotation_api
kb_uploadmethods	github.com/kbaseapps/kb_uploadmethods
KBaseReport	github.com/kbaseapps/KBaseReport
SetAPI		github.com/kbaseapps/SetAPI
TaxonAPI	github.com/kbase/taxon_api
ReadsUtils	github.com/kbaseapps/ReadsUtils
AssemblyAPI	github.com/kbase/assembly_api
AssemblyUtil	github.com/kbaseapps/AssemblyUtil
AssemblySequenceAPI	github.com/kbaseapps/AssemblySequenceAPI
MetagenomeAPI	github.com/kbaseapps/MetagenomeAPI
MetagenomeUtils	github.com/kbaseapps/MetagenomeUtils
FeatureSetUtils	github.com/kbaseapps/FeatureSetUtils
ExpressionUtils	github.com/kbaseapps/ExpressionUtils
FBAFileUtil	github.com/kbaseapps/FBAFileUtil
GenericsAPI	github.com/kbaseapps/GenericsAPI
GenericsService	github.com/kbaseapps/GenericsService
KBParallel	github.com/kbaseapps/KBParallel
ReadsAlignmentUtils	github.com/kbaseapps/ReadsAlignmentUtils
PanGenomeAPI	github.com/kbaseapps/PanGenomeAPI
PangenomeFileUtil	github.com/kbaseapps/PangenomeFileUtilImpl
BiochemistryAPI	github.com/kbaseapps/BiochemistryAPI
GenomeSearchUtil	github.com/kbaseapps/GenomeSearchUtil
NarrativeService	github.com/kbaseapps/NarrativeService
KBaseFeatureValues	github.com/kbaseapps/FeatureValues
kb_Metrics	github.com/kbaseapps/kb_Metrics
kb_ea_utils	github.com/kbaseapps/kb_ea_utils
kb_quast	github.com/kbaseapps/kb_quast
SpeciesTreeBuilder	github.com/kbaseapps/SpeciesTreeBuilder
CompoundSetUtils	github.com/kbaseapps/CompoundSetUtils
JobBrowserBFF	github.com/kbaseapps/kbase-sdk-module-job-browser-bff
OntologyAPI	github.com/kbaseapps/ontology_api
SampleService	github.com/kbase/sample_service